https://bitbucket.org/anticheat/smac/wiki/Wallhack
Official Modules

Required
	SourceMod Anti-Cheat - smac.smx

Recommended
	Aimbot Detector - smac_aimbot.smx
	AutoTrigger Detector - smac_autotrigger.smx
	Client Protection - smac_client.smx
	Command Monitor - smac_commands.smx
	ConVar Checker - smac_cvars.smx
	Eye Angle Test - smac_eyetest.smx
	Rcon Locker - smac_rcon.smx
	Anti-Speedhack - smac_speedhack.smx

Optional
	Anti-Wallhack - smac_wallhack.smx
	Spinhack Detector - smac_spinhack.smx

Game Specific
	Counter-Strike: Source
		Anti-Flash - smac_css_antiflash.smx
		Anti-Smoke - smac_css_antismoke.smx
		Exploit Fixes - smac_css_fixes.smx
	Left 4 Dead 2
		Exploit Fixes - smac_l4d2_fixes.smx
	Half-Life 2: Deathmatch
		Exploit Fixes - smac_hl2dm_fixes.smx

Global Banlists
	EasyAntiCheat - smac_eac_banlist.smx
	E-Sports Entertainment - smac_esea_banlist.smx
	Kigen's Anti-Cheat - smac_kac_banlist.smx

Third-Party Modules
	SMAC AutoDemo